1111111111111111
1000000C001P0001
1E00000000000001
1111111111111111