1111111111111111
100000CCC1P10001
1CECC11000000001
1111111111111111