11111111111111111111
100C00000000000C0001
1P000000000001111111
111111CCCCC000011111
1ECC0000011111000011
11111111111111111111