111111111111111111111111111
1000000000000000P0000000001
1E11E1E1E1E1E1E1E1E1E1E0011
10000000CCCCCCCCCCC11110011
100011111111100000000001001
100001111111110000000000001
100000000000000000000000001
100000000000000000000000001
1E11E1E1E1E1E1E1E1E1E1E0011
10000000CCCCCCCCCCC11110011
100011111111100000000001001
100001111111110000000000001
100000000000000000000000001
100000000000000000000000001
1E11E1E1E1E1E1E1E1E1E1E0011
10000000CCCCCCCCCCC11110011
100011111111100000000001001
100001111111110000000000001
100000000000000000000000001
100000000000000000000000001
1E11E1E1E1E1E1E1E1E1E1E0011
10000000CCCCCCCCCCC11110011
100011111111100000000001001
100001111111110000000000001
100000000000000000000000001
100000000000000000000000001
1E11E1E1E1E1E1E1E1E1E1E0011
10000000CCCCCCCCCCC11110011
100011111111100000000001001
100001111111110000000000001
100000000000000000000000001
111111111111111111111111111