11111111111111110111111111111
10000000000000000111111111110
11111111111111111111111111110